0000000000000
0211120111120
0100010000010
0100010000010
0211120111120
0000010100000
0211120111120
0000000000000
0111112111110
0001000001000
0000000000000
0000011100000
0000010108000