0044000044019
4213320133124
4100010000014
4100010000014
4211120111124
4000010100004
4233320133324
0044000004400
0111112111110
0001000001000
0044444444400
0000011100000
0000010108000